NO ./textures/N.xpm
SO ./textures/S.xpm
WE ./textures/W.xpm
EA ./textures/E.xpm

F 120,50,100
C 105,30,50

1111111111111
1000000100111
1100000000111
100N000111111
10111000000001
11  1111000011
111111  1111
